antes	anCis
bicho	bi$u
braço	brasu
braços	brasus
cada	kada
cantar	kantar
caro	karu
carro	kaRu
casa	kaza
case	kazi
chato	$atu
diferentes	JiferenCis
disse	Jisi
filhos	fiLus
gatinho	gaCiNu
livro	livru
luz	lus
me	mi
ninhos	niNus
parede	pareJi
paredes	pareJis
parte	parCi
partes	parCis
pedaço	pedasu
peru	piru
rápido	Rápidu
sabe	sabi
simpático	simpáCiku
verdade	verdaJi
vermelho	vermeLu
